DK|Denmark
FI|Finland
NO|Norway
SE|Sweden
---
AR|Argentina
AU|Australia
AT|Austria
BE|Belgium 
BR|Brazil
CA|Canada 
CN|China
CZ|Czech Republic
DK|Denmark
EG|Egypt
EE|Estonia
FI|Finland
FR|France
DE|Germany
GR|Greece
HK|Hong Kong
IS|Iceland
IN|India
ID|Indonesia
IE|Ireland
IL|Israel
IT|Italy 
JP|Japan
KP|Korea, North
KR|Korea, South
LV|Latvia
LB|Lebanon
LT|Lithuania
LU|Luxembourg
MY|Malaysia
MT|Malta
MX|Mexico
NL|Netherlands
NZ|New Zealand
NO|Norway
PL|Poland
RU|Russia
CS|Serbia-Montenegro
SG|Singapore
ZA|South Africa
ES|Spain
SE|Sweden
CH|Switzerland
TH|Thailand
TR|Turkey
GB|United Kingdom
US|USA
---
OT| Other country
